63 63



                           #########
                       ####         ####
                    ###                 ###
                  ##                       ##
                 #         #########         #
               ##       ###         ###       ##
              #      ###               ###      #
            ##     ##                     ##     ##
           #      #         #######         #      #
          #     ##      ####       ####      ##     #
         #     #      ##               ##      #     #
        #     #     ##                   ##     #     #
        #    #     #        #######        #     #    #
       #    #     #      ###       ###      #     #    #
      #    #     #     ##             ##     #     #    #
      #   #     #     #                 #     #     #   #
     #    #    #    ##       #####       ##    #    #    #
    #    #    #    #      ###     ###      #    #    #    #
    #   #    #    #     ##           ##     #    #    #   #
   #    #   #    #     #               #     #    #   #    #
   #   #    #    #    #      #####      #    #    #    #   #
   #   #   #    #    #     ##     ##     #    #    #   #   #
  #    #   #   #    #     #         #     #    #   #   #    #
  #   #   #    #   #     #           #     #   #    #   #   #
  #   #   #   #    #    #     ###     #    #    #   #   #   #
  #   #   #   #   #    #    ##   ##    #    #   #   #   #   #
 #   #    #   #   #   #    #       #    #   #   #   #    #   #
 #   #   #   #    #   #   #         #   #   #    #   #   #   #
 #   #   #   #   #   #    #    #    #    #   #   #   #   #   #
 #   #   #   #   #   #   #    # #    #   #   #   #   #   #   #
 #   #   #   #   #   #   #   #   #   #   #   #   #   #   #   #
 #   #   #   #   #       #   #   #       #   #   #   #   #   #
 #   #   #   #    #      #   #   #      #    #   #   #   #   #
 #   #    #   #    #     #   #   #     #    #   #    #   #   #
  #   #   #    #    ######   #   ######    #    #   #   #    #
  #   #   #    #             #             #    #   #   #   #
  #    #   #    ##           #           ##    #   #    #   #
   #   #    #     #          #          #     #    #   #    #
   #    #    #     #####################     #    #    #   #
    #   #     #              #              #     #   #    #
    #    #     #             #             #     #    #   #
     #    #     ###          #          ###     #    #    #
      #    #       #######   #   #######       #    #    #
      #     ##           #   #   #           ##     #    #
       #      ##         #   #   #         ##      #    #
        ##      ##       #   #   #       ##      ##    #
          #       ####   #   #   #   ####       #     #
           ##            #   #   #            ##     #
             ##         #    #    #         ##      #
               ###     #      #    #     ###       #
                  #####        #    #####        ##
                               #               ##
                                ##           ##
                                  #       ###
                                   #######




