134 134
















                 #####################################################################################################################
                 #                                                         #                                                         #
                 #                                                         #                                                         #
                 #                                                         #                                                         #
                 #   ###################################################   #   ###################################################   #
                 #   #                                                     #                                                     #   #
                 #   #                                                     #                                                     #   #
                 #   #                                                     #                                                     #   #
                 #   #   #####################################################################################################   #   #
                 #   #   #                                                                                                   #   #   #
                 #   #   #                                                                                                   #   #   #
                 #   #   #                                                                                                   #   #   #
                 #   #   #   #############################################################################################   #   #   #
                 #   #   #   #                                             #                                             #   #   #   #
                 #   #   #   #                                             #                                             #   #   #   #
                 #   #   #   #                                             #                                             #   #   #   #
                 #   #   #   #   #######################################   #   #######################################   #   #   #   #
                 #   #   #   #   #                                         #                                         #   #   #   #   #
                 #   #   #   #   #                                         #                                         #   #   #   #   #
                 #   #   #   #   #                                         #                                         #   #   #   #   #
                 #   #   #   #   #   #############################################################################   #   #   #   #   #
                 #   #   #   #   #   #                                                                           #   #   #   #   #   #
                 #   #   #   #   #   #                                                                           #   #   #   #   #   #
                 #   #   #   #   #   #                                                                           #   #   #   #   #   #
                 #   #   #   #   #   #   #####################################################################   #   #   #   #   #   #
                 #   #   #   #   #   #   #                                 #                                 #   #   #   #   #   #   #
                 #   #   #   #   #   #   #                                 #                                 #   #   #   #   #   #   #
                 #   #   #   #   #   #   #                                 #                                 #   #   #   #   #   #   #
                 #   #   #   #   #   #   #   ###########################   #   ###########################   #   #   #   #   #   #   #
                 #   #   #   #   #   #   #   #                             #                             #   #   #   #   #   #   #   #
                 #   #   #   #   #   #   #   #                             #                             #   #   #   #   #   #   #   #
                 #   #   #   #   #   #   #   #                             #                             #   #   #   #   #   #   #   #
                 #   #   #   #   #   #   #   #   #####################################################   #   #   #   #   #   #   #   #
                 #   #   #   #   #   #   #   #   #                                                   #   #   #   #   #   #   #   #   #
                 #   #   #   #   #   #   #   #   #                                                   #   #   #   #   #   #   #   #   #
                 #   #   #   #   #   #   #   #   #                                                   #   #   #   #   #   #   #   #   #
                 #   #   #   #   #   #   #   #   #   #############################################   #   #   #   #   #   #   #   #   #
                 #   #   #   #   #   #   #   #   #   #                                           #   #   #   #   #   #   #   #   #   #
                 #   #   #   #   #   #   #   #   #   #                                           #   #   #   #   #   #   #   #   #   #
                 #   #   #   #   #   #   #   #   #   #                                           #   #   #   #   #   #   #   #   #   #
                 #   #   #   #   #   #   #   #   #   #   #####################################   #   #   #   #   #   #   #   #   #   #
                 #   #   #   #   #   #   #   #   #   #   #                                   #   #   #   #   #   #   #   #   #   #   #
                 #   #   #   #   #   #   #   #   #   #   #                                   #   #   #   #   #   #   #   #   #   #   #
                 #   #   #   #   #   #   #   #   #   #   #                                   #   #   #   #   #   #   #   #   #   #   #
                 #   #   #   #   #   #   #   #   #   #   #                                   #   #   #   #   #   #   #   #   #   #   #
                 #   #   #   #   #   #   #   #   #   #   #                                   #   #   #   #   #   #   #   #   #   #   #
                 #   #   #   #   #   #   #   #   #   #   #                                   #   #   #   #   #   #   #   #   #   #   #
                 #   #   #   #   #   #   #   #   #   #   #                                   #   #   #   #   #   #   #   #   #   #   #
                 #   #   #   #   #   #   #   #   #   #   #                                   #   #   #   #   #   #   #   #   #   #   #
                 #   #   #   #   #   #   #   #   #   #   #                                   #   #   #   #   #   #   #   #   #   #   #
                 #   #   #   #   #   #   #   #   #   #   #                                   #   #   #   #   #   #   #   #   #   #   #
                 #   #   #   #   #   #   #   #   #   #   #                                   #   #   #   #   #   #   #   #   #   #   #
                 #   #   #   #   #   #   #   #   #   #   #                                   #   #   #   #   #   #   #   #   #   #   #
                 #   #   #   #   #   #   #   #   #   #   #                                   #   #   #   #   #   #   #   #   #   #   #
                 #   #   #   #   #   #   #   #   #   #   #                                   #   #   #   #   #   #   #   #   #   #   #
                 #   #       #   #       #   #       #   #                                   #   #       #   #       #   #       #   #
                 #   #       #   #       #   #       #   #                                   #   #       #   #       #   #       #   #
                 #   #       #   #       #   #       #   #                                   #   #       #   #       #   #       #   #
                 #   #########   #########   #########   #                                   #   #########   #########   #########   #
                 #   #       #   #       #   #       #   #                                   #   #       #   #       #   #       #   #
                 #   #       #   #       #   #       #   #                                   #   #       #   #       #   #       #   #
                 #   #       #   #       #   #       #   #                                   #   #       #   #       #   #       #   #
                 #   #   #   #   #   #   #   #   #   #   #                                   #   #   #   #   #   #   #   #   #   #   #
                 #   #   #   #   #   #   #   #   #   #   #                                   #   #   #   #   #   #   #   #   #   #   #
                 #   #   #   #   #   #   #   #   #   #   #                                   #   #   #   #   #   #   #   #   #   #   #
                 #   #   #   #   #   #   #   #   #   #   #                                   #   #   #   #   #   #   #   #   #   #   #
                 #   #   #   #   #   #   #   #   #   #   #                                   #   #   #   #   #   #   #   #   #   #   #
                 #   #   #   #   #   #   #   #   #   #   #                                   #   #   #   #   #   #   #   #   #   #   #
                 #   #   #   #   #   #   #   #   #   #   #                                   #   #   #   #   #   #   #   #   #   #   #
                 #   #   #   #   #   #   #   #   #   #   #                                   #   #   #   #   #   #   #   #   #   #   #
                 #   #   #   #   #   #   #   #   #   #   #                                   #   #   #   #   #   #   #   #   #   #   #
                 #   #   #   #   #   #   #   #   #   #   #                                   #   #   #   #   #   #   #   #   #   #   #
                 #   #   #   #   #   #   #   #   #   #   #                                   #   #   #   #   #   #   #   #   #   #   #
                 #   #   #   #   #   #   #   #   #   #   #                                   #   #   #   #   #   #   #   #   #   #   #
                 #   #   #   #   #   #   #   #   #   #   #                                   #   #   #   #   #   #   #   #   #   #   #
                 #   #   #   #   #   #   #   #   #   #   #                                   #   #   #   #   #   #   #   #   #   #   #
                 #   #   #   #   #   #   #   #   #   #   #################   #################   #   #   #   #   #   #   #   #   #   #
                 #   #   #   #   #   #   #   #   #   #                   #   #                   #   #   #   #   #   #   #   #   #   #
                 #   #   #   #   #   #   #   #   #   #                   #   #                   #   #   #   #   #   #   #   #   #   #
                 #   #   #   #   #   #   #   #   #   #                   #   #                   #   #   #   #   #   #   #   #   #   #
                 #   #   #   #   #   #   #   #   #   #################   #   #   #################   #   #   #   #   #   #   #   #   #
                 #   #   #   #   #   #   #   #   #                       #   #                       #   #   #   #   #   #   #   #   #
                 #   #   #   #   #   #   #   #   #                       #   #                       #   #   #   #   #   #   #   #   #
                 #   #   #   #   #   #   #   #   #                       #   #                       #   #   #   #   #   #   #   #   #
                 #   #   #   #   #   #   #   #   #########################   #########################   #   #   #   #   #   #   #   #
                 #   #   #   #   #   #   #   #                               #                           #   #   #   #   #   #   #   #
                 #   #   #   #   #   #   #   #                               #                           #   #   #   #   #   #   #   #
                 #   #   #   #   #   #   #   #                               #                           #   #   #   #   #   #   #   #
                 #   #   #   #   #   #   #   #################################   #########################   #   #   #   #   #   #   #
                 #   #   #   #   #   #   #                                   #   #                           #   #   #   #   #   #   #
                 #   #   #   #   #   #   #                                   #   #                           #   #   #   #   #   #   #
                 #   #   #   #   #   #   #                                   #   #                           #   #   #   #   #   #   #
                 #   #   #   #   #   #   #################################   #   #   #########################   #   #   #   #   #   #
                 #   #   #   #   #   #                                   #   #   #                               #   #   #   #   #   #
                 #   #   #   #   #   #                                   #   #   #                               #   #   #   #   #   #
                 #   #   #   #   #   #                                   #   #   #                               #   #   #   #   #   #
                 #   #   #   #   #   #################################   #   #   #################################   #   #   #   #   #
                 #   #   #   #   #                                   #   #   #   #                                   #   #   #   #   #
                 #   #   #   #   #                                   #   #   #   #                                   #   #   #   #   #
                 #   #   #   #   #                                   #   #   #   #                                   #   #   #   #   #
                 #   #   #   #   #################################   #   #   #   #   #################################   #   #   #   #
                 #   #   #   #                                   #   #   #   #   #                                       #   #   #   #
                 #   #   #   #                                   #   #   #   #   #                                       #   #   #   #
                 #   #   #   #                                   #   #   #   #   #                                       #   #   #   #
                 #   #   #   #################################   #   #   #   #   #########################################   #   #   #
                 #   #   #                                       #   #   #   #                                               #   #   #
                 #   #   #                                       #   #   #   #                                               #   #   #
                 #   #   #                                       #   #   #   #                                               #   #   #
                 #   #   #########################################   #   #   #################################################   #   #
                 #   #                                               #   #   #                                                   #   #
                 #   #                                               #   #   #                                                   #   #
                 #   #                                               #   #   #                                                   #   #
                 #   #################################################   #   #   #################################################   #
                 #                                                       #   #                                                       #
                 #                                                       #   #                                                       #
                 #                                                       #   #                                                       #
                 #########################################################   #########################################################

















