139 139











                                                              ##                       ##
                                                           ### #                       # ##
                                                         ##    #                       #   ###
                                                      ###       #                     #       ###
                                                   ###          #                     #          ##
                                                 ##             #                     #            ###
                                              ###               #                     #               ###
                                           ###                  #                     #                  ##
                                         ##                      #                   #                     ###
                                       ##                        #                   #                        ##
                                      #                          #                   #                          #
                                     #                           #                   #                           #
                                    #                            #                   #                            #
                                   #                              #                 #                              #
                                  #       #                       #                 #                       #       #
                                 #       # #                      #                 #                      # #       #
                                #       #  #                      #                 #                      #  #       #
                               #       #    #                     #                 #                     #    #       #
                              #       #      #                     #               #                     #      #       #
                             #       #       #                     #               #                     #       #       #
                            #       #         #                    #               #                    #         #       #
                           #       #           #                   #               #                   #           #       #
                          #       #            #                   #               #                   #            #       #
                         #       #              #                   #             #                   #              #       #
                        #       #                #                  #             #                  #                #       #
                       #       #                 #                  #             #                  #                 #       #
                      #       #                   #                 #             #                 #                   #       #
                     #       #                     #                 #           #                 #                     #       #
                     #      #                      #                 #           #                 #                      #      #
                    #      #                        #                #           #                #                        #      #
                    #     #                          #               #           #               #                          #     #
                   #      #                          #               #           #               #                          #      #
                   #     #                            #               #         #               #                            #     #
                   #     #    #                        #              #         #              #                        #    #     #
                  #     #     ###                      #              #         #             #                       ###     #     #
                  #     #    #   #                      #             #         #             #                      #   #    #     #
                  #     #    #    ##                     #            #         #            #                     ##    #    #     #
                 #     #    #       #                    #             #       #            #                     #       #    #     #
                 #     #    #        ##                   #            #       #            #                   ##        #    #     #
                #     #     #          #                   #           #       #           #                   #          #     #     #
                #     #    #            ##                 #           #       #          #                  ##            #    #     #
                #    #     #              #                 #          #       #          #                 #              #     #    #
               #     #    #                ##                #          #     #          #                ##                #    #     #
               #     #    #                  #               #          #     #         #               ##                  #    #     #
               #    #     #                   ##              #         #     #         #              #                    #     #    #
              #     #    #                      #              #        #     #        #             ##                      #    #     #
              #    #     #                       ##            #        #     #       #             #                        #     #    #
             #     #    #                          #            #        #   #        #           ##                          #    #     #
             #     #    #                           ##                   #   #       #           #                            #    #     #
             #    #     #                             #                  #   #      #          ##                             #     #    #
            #     #    #                               ##              ##    #      #         #                                #    #     #
            #    #     #                                 #           ##      #     #        ##                                 #     #    #
            #    #    #                                   ##        #       #       #      #                                    #    #    #
            #    #    #                                     #     ##        #       #                                           #    #    #
            #    #    #   ###                                ## ##          #        #                                    ###   #    #    #
            #    #    #   #  #####                             #           # #       #                               #####  #   #    #    #
            #    #    #   #       #####                                  ##   #       #                         #####       #   #    #    #
            #    #    #   #            #####                            #     #        #                   #####            #   #    #    #
            #    #    #   #                 #####                      #       #       #              #####                 #   #    #    #
            #    #    #   #                      #####                #         #       #        #####                      #   #    #    #
            #    #    #   #                           #####         ##           #      #   #####                           #   #    #    #
            #    #    #   #                                #####   #              #      ###                                #   #    #    #
            #    #    #   #                                     ###               #                                         #   #    #    #
            #    #    #   #                                        #               #                                        #   #    #    #
            #    #    #   #                                         #               ###                                     #   #    #    #
            #    #    #   #                                ###      #              #   #####                                #   #    #    #
            #    #    #   #                           #####   #      #           ##         #####                           #   #    #    #
            #    #    #   #                      #####        #       #         #                #####                      #   #    #    #
            #    #    #   #                 #####              #       #       #                      #####                 #   #    #    #
            #    #    #   #            #####                   #        #     #                            #####            #   #    #    #
            #    #    #   #       #####                         #       #   ##                                  #####       #   #    #    #
            #    #    #   #    ###                               #       # #           #                             ###    #   #    #    #
            #    #    #   #    #                                 #        #          ## ##                             #    #   #    #    #
            #    #    #   #     #                                 #       #        ##     #                           #     #   #    #    #
            #    #    #    #    #                          #      #       #       #        ##                         #    #    #    #    #
            #    #     #   #     #                       ##        #     #      ##           #                       #     #   #     #    #
            #     #    #    #    #                      #         #      #    ##              ##                     #    #    #    #     #
             #    #     #   #    #                    ##          #      #   #                  #                    #    #   #     #    #
             #     #    #    #    #                  #           #       #   #                   ##                 #    #    #    #     #
              #    #    #    #    #                ##           #        #   #        #            #                #    #    #    #    #
              #    #     #    #    #             ##             #       #     #        #            ##             #    #    #     #    #
              #     #    #    #    #            #              #        #     #        #              #            #    #    #    #     #
               #    #     #   #     #         ##              #         #     #         #              ##         #     #   #     #    #
               #     #    #    #    #        #                #         #     #         #                #        #    #    #    #     #
               #     #    #    #    #      ##                #          #     #          #                ##      #    #    #    #     #
                #     #    #    #    #    #                  #         #       #          #                 #    #    #    #    #     #
                #     #    #    #    #     #                #          #       #          #                #     #    #    #    #     #
                 #    #     #    #    #     #              #           #       #           #              #     #    #    #     #    #
                 #     #    #    #    #      #             #           #       #            #            #      #    #    #    #     #
                 #     #    #     #    #      #           #            #       #            #           #      #    #     #    #     #
                  #     #    #    #     #      #         #            #         #            #         #      #     #    #    #     #
                  #     #    #     #     #      #        #            #         #            #        #      #     #     #    #     #
                  #     #     #     #     #      #      ##            ###########            ##      #      #     #     #     #     #
                   #     #    #      #     #      #       ##                               ##       #      #     #      #    #     #
                   #     #     #      #     #      #        ###                         ###        #      #     #      #     #     #
                    #     #     #      #     #      #          ###                   ###          #      #     #      #     #     #
                    #     #      #      #     #      ##           ##               ##           ##      #     #      #      #     #
                    #      #      #      #     #       ##           ###############           ##       #     #      #      #      #
                     #      #      #      #     #        ###                               ###        #     #      #      #      #
                     #       #      #      #     #          ##                           ##          #     #      #      #       #
                      #       #      #      #     ##          ###                     ###          ##     #      #      #       #
                       #       #      #      #      ##           ##                 ##           ##      #      #      #       #
                        #       #      #      #       ###          #################          ###       #      #      #       #
                         #       #      #      #         ##                                 ##         #      #      #       #
                          #       #      #      ##         ##                             ##         ##      #      #       #
                           #       #      #       ##         ###                       ###         ##       #      #       #
                            #       #      #        ##          ##                   ##          ##        #      #       #
                             #       #      #         ##          ###################          ##         #      #       #
                              #       #      ##         ###                                 ###         ##      #       #
                               #       #       ##          ##                             ##          ##       #       #
                                #       #        ###         ##                         ##         ###        #       #
                                 #       #          ##         ##                     ##         ##          #       #
                                  #       ##          ###        #####################        ###          ##       #
                                   #        ##           ##                                 ##           ##        #
                                    #         ###          ###                           ###          ###         #
                                     #           ##           ##                       ##           ##           #
                                      #            ##           #######################          ###            #
                                       ##            ###                                       ##             ##
                                         ##             ##                                   ##            ###
                                           ###            ###                             ###            ##
                                              ###            ##                         ##            ###
                                                 ##            #########################           ###
                                                   ###                                           ##
                                                      ###                                     ###
                                                         ##                                ###
                                                           ###                           ##
                                                              ###########################












