€ ﬂﬂ€ﬂﬂﬂﬂﬂ€ﬂ€ﬂﬂﬂ€ﬂ€ﬂﬂﬂﬂﬂﬂﬂﬂﬂﬂﬂﬂﬂ€ﬂﬂﬂﬂﬂ€ﬂﬂﬂﬂﬂﬂﬂﬂﬂﬂﬂ€ﬂﬂﬂﬂﬂ€ﬂﬂﬂﬂﬂ€
€ ﬂﬂﬂ € € € ﬂ € € ﬂ €ﬂ€ﬂﬂﬂ€ € €ﬂﬂ € € €ﬂﬂﬂﬂﬂﬂﬂﬂﬂﬂ € € €ﬂﬂ ﬂﬂ€ €
€ €ﬂﬂﬂ€ﬂﬂ €ﬂﬂ € € ﬂﬂﬂ € € ﬂ €ﬂﬂ €ﬂﬂﬂ€ € ﬂﬂ€ﬂﬂﬂ€ﬂﬂ ﬂ €ﬂﬂ €ﬂ€ € €
€ € € € ﬂﬂ€ ﬂﬂ€ €ﬂﬂﬂ€ € €ﬂﬂﬂﬂ €ﬂﬂ € € ﬂﬂ€ € € € ﬂﬂﬂﬂ€ € € ﬂ ﬂﬂ€
€ ﬂ € €ﬂ€ ﬂﬂﬂﬂﬂ € ﬂﬂ€ € € € ﬂﬂ€ ﬂﬂ€ ﬂﬂ€ € ﬂ € ﬂﬂ€ﬂ€ ﬂ € €ﬂﬂﬂ€ €
€ﬂﬂﬂ€ € ﬂﬂ€ﬂ€ﬂﬂﬂﬂﬂ€ ﬂ € €ﬂﬂﬂﬂ €ﬂﬂ ﬂﬂ€ € ﬂﬂﬂﬂﬂﬂ€ € ﬂﬂ€ﬂﬂ € ﬂﬂﬂ €
€ € € ﬂﬂﬂ € € € € ﬂﬂﬂﬂ€ ﬂ €ﬂﬂﬂ€ €ﬂﬂ € € ﬂﬂ€ﬂﬂ € ﬂﬂ€ ﬂ €ﬂﬂﬂ€ﬂﬂ €
€ € €ﬂ€ ﬂﬂﬂ € € ﬂﬂ€ﬂﬂ €ﬂﬂﬂﬂ € € € ﬂﬂ€ ﬂﬂﬂ € ﬂﬂ€ﬂﬂ ﬂﬂﬂﬂﬂ € € ﬂﬂ€
€ € € € ﬂﬂﬂﬂ€ €ﬂ€ € €ﬂﬂ €ﬂﬂﬂﬂﬂﬂ €ﬂﬂﬂ€ﬂﬂﬂﬂﬂﬂﬂ€ € ﬂﬂﬂﬂﬂﬂ€ﬂ€ ﬂﬂﬂﬂ€
€ € € €ﬂﬂﬂﬂ ﬂ € ﬂ € ﬂ € € €ﬂﬂﬂ€ﬂﬂ € ﬂ € €ﬂﬂ € ﬂﬂﬂﬂﬂﬂ€ € €ﬂﬂﬂﬂ €
€ € € ﬂ €ﬂﬂﬂ€ﬂﬂﬂ€ﬂﬂ €ﬂﬂ ﬂ € € € €ﬂﬂﬂ€ﬂﬂﬂ€ ﬂﬂﬂﬂ€ﬂﬂﬂ€ ﬂ € ﬂ €ﬂﬂﬂ€
€ﬂﬂ ﬂﬂﬂﬂ€ €ﬂﬂ € € ﬂﬂ€ ﬂﬂ€ﬂﬂ € ﬂ € €ﬂﬂ € €ﬂﬂﬂ€ ﬂ € ﬂﬂﬂﬂﬂ €ﬂﬂ € €
€ €ﬂﬂﬂ€ € ﬂ €ﬂﬂ €ﬂ€ ﬂﬂﬂﬂ€ €ﬂﬂﬂ€ﬂﬂ € ﬂﬂ€ ﬂ €ﬂﬂﬂﬂﬂ€ﬂﬂﬂ€ € €ﬂﬂﬂﬂ €
€ ﬂﬂ€ ﬂ € €ﬂﬂ €ﬂﬂ ﬂﬂ€ﬂﬂ € € € ﬂ €ﬂﬂﬂﬂﬂ€ﬂﬂ € ﬂﬂ€ﬂﬂ € € €ﬂﬂ €ﬂﬂ €
€ € ﬂﬂﬂﬂﬂ € ﬂﬂﬂﬂ€ € ﬂﬂ€ﬂﬂ € ﬂﬂﬂﬂ€ ﬂﬂ€ ﬂ €ﬂﬂﬂﬂ € €ﬂﬂ € € €ﬂﬂﬂ€ €
€ ﬂﬂ€ﬂﬂﬂﬂﬂﬂﬂﬂﬂﬂ € € € ﬂﬂ€ ﬂﬂ€ € ﬂﬂﬂ €ﬂﬂﬂﬂ ﬂﬂﬂﬂﬂ € €ﬂ€ ﬂ ﬂ € ﬂﬂ€
€ € €ﬂﬂﬂ€ﬂﬂﬂ€ﬂﬂﬂ€ ﬂﬂﬂﬂ€ ﬂﬂ€ ﬂﬂﬂﬂﬂﬂﬂ ﬂﬂ€ﬂﬂﬂ€ﬂﬂﬂﬂﬂ€ € ﬂﬂﬂﬂﬂﬂﬂﬂﬂ €
€ € ﬂ € ﬂ € € € ﬂﬂ€ﬂﬂ €ﬂﬂ ﬂﬂﬂﬂﬂﬂﬂﬂ€ﬂ€ € € €ﬂﬂ € ﬂ € €ﬂﬂﬂ€ﬂﬂﬂﬂ €
€ ﬂﬂﬂﬂ€ﬂﬂﬂﬂ € €ﬂﬂ € ﬂﬂ€ ﬂﬂ€ﬂﬂ €ﬂﬂ ﬂ € ﬂﬂﬂ € €ﬂﬂ €ﬂ€ﬂﬂ € € ﬂﬂﬂﬂ€
€ﬂﬂﬂﬂ € ﬂﬂﬂﬂ€ € ﬂﬂﬂﬂﬂﬂ€ €ﬂﬂ ﬂﬂ€ €ﬂﬂﬂﬂﬂﬂﬂ€ € € ﬂﬂ€ ﬂ €ﬂﬂ € €ﬂﬂﬂ€
€ €ﬂﬂﬂﬂﬂ€ € € ﬂﬂﬂﬂ€ﬂﬂ €ﬂﬂ €ﬂﬂ € ﬂﬂﬂﬂﬂﬂﬂ € € ﬂﬂﬂﬂﬂ €ﬂ€ €ﬂﬂ € € €
€ﬂﬂ € € ﬂﬂﬂ €ﬂﬂﬂ€ € ﬂﬂ€ ﬂﬂﬂﬂ€ﬂﬂ €ﬂﬂﬂ€ﬂﬂﬂ€ ﬂﬂ€ﬂﬂ € € ﬂ € € ﬂ € €
€ € ﬂﬂ€ﬂﬂﬂﬂﬂﬂ € ﬂ €ﬂﬂ €ﬂﬂﬂ€ € €ﬂﬂ € ﬂ € €ﬂ€ ﬂﬂ€ﬂﬂﬂﬂﬂ€ ﬂﬂﬂﬂﬂﬂﬂﬂ€
€ €ﬂ€ ﬂ €ﬂﬂﬂﬂﬂ€ﬂﬂﬂ€ ﬂﬂﬂ € ﬂ € ﬂﬂﬂ € ﬂﬂ€ ﬂ €ﬂﬂ € € € ﬂﬂﬂﬂ€ﬂ€ﬂﬂ €
€ € ﬂﬂﬂﬂ€ ﬂﬂ€ € € ﬂﬂ€ ﬂﬂ€ﬂﬂﬂﬂﬂ€ﬂﬂﬂﬂﬂ€ﬂﬂ €ﬂﬂ € ﬂ € €ﬂﬂﬂ€ ﬂ € ﬂﬂ€
€ ﬂﬂ€ﬂ€ €ﬂﬂ € € ﬂﬂ€ ﬂﬂ€ € ﬂﬂ€ ﬂﬂﬂﬂ€ ﬂ €ﬂﬂ ﬂﬂﬂﬂ€ﬂﬂﬂ€ ﬂﬂ€ €ﬂﬂﬂ€ €
€ € ﬂ € ﬂ €ﬂ€ ﬂﬂ€ ﬂﬂﬂﬂ€ ﬂﬂ€ €ﬂﬂ € €ﬂﬂﬂﬂ ﬂﬂ€ﬂﬂﬂﬂ € €ﬂﬂ € ﬂ € ﬂ €
€ﬂﬂﬂﬂ ﬂﬂﬂﬂﬂ € € ﬂﬂ€ﬂﬂ € €ﬂﬂ € €ﬂﬂﬂﬂ €ﬂﬂﬂﬂﬂﬂ € ﬂﬂ€ ﬂ € €ﬂ€ﬂﬂﬂﬂﬂ€
€ ﬂﬂﬂﬂ€ﬂﬂﬂ€ﬂﬂ ﬂﬂ€ ﬂ €ﬂﬂ ﬂ €ﬂﬂ € ﬂﬂﬂﬂﬂ €ﬂﬂﬂﬂﬂﬂﬂﬂﬂ€ﬂﬂﬂﬂ € ﬂ €ﬂﬂ €
€ﬂﬂﬂ€ ﬂ € €ﬂﬂ € €ﬂ€ € €ﬂﬂﬂﬂﬂﬂﬂ€ﬂﬂﬂ€ ﬂﬂﬂﬂ€ €ﬂﬂﬂ€ ﬂ € €ﬂﬂﬂﬂﬂ€ € €
€ ﬂﬂﬂﬂﬂﬂﬂ ﬂ €ﬂﬂ € ﬂ € ﬂ €ﬂﬂ € ﬂ € ﬂﬂﬂﬂﬂ € ﬂﬂﬂ € ﬂﬂﬂﬂﬂ €ﬂﬂ ﬂ € €
ﬂﬂﬂﬂﬂﬂﬂﬂﬂﬂﬂﬂﬂﬂﬂﬂﬂﬂﬂﬂﬂﬂﬂﬂﬂﬂﬂﬂﬂﬂﬂﬂﬂﬂﬂﬂﬂﬂﬂﬂﬂﬂﬂﬂﬂﬂﬂﬂﬂﬂﬂﬂﬂﬂﬂﬂﬂﬂﬂﬂﬂ ﬂ