63 63
##### #########################################################
#   #                   #       # #       #       #   #       #
# ### ####### ##### ##### ### # # # ### # ### ##### # # # #####
#   # # #   #     #   #     # # #   #   #     #     #   #     #
# # # # # # ##### ### # ##### # ##### ####### # ############# #
# #   # # #     # # #   #     #       #   #   # #       # #   #
# ##### # ##### # # ##### ############# ### ### # # ### # # ###
#   #   #   #   #       #   #     #     #   #   # #   #   #   #
### # # ### ### ########### # ##### # ### ### ##### # ####### #
# # # #   #   #             # #     #   # #   #   # # #       #
# # # # # ### ############### # ####### # # ### # # # # ##### #
# # # # #   # #   #           #       #   #   # # # # # #     #
# # ### ##### ### # ##### ### ####### ####### # # ### # ##### #
# # #   #   #   # # #   #   #     # #   #   #   #     #     # #
# # # ### # ### # # # # ### ##### # ### # # ######### ##### ###
#   #   # #   # #   # #     #         # # #   #     # #   #   #
# ##### # ### # ##### ######### ##### # # # # ### ### ### ### #
#   #   #   # #     #         # #   # # # # #   # #   #   #   #
### # ##### # # ### # ####### ### # ### ### ### # # ### # # ###
# # # #     # #   # # #     #     #   #     # # # #     # #   #
# # # # ##### ##### # ### # ######### ####### # # ####### ### #
# #   #   # # #     #     #   # #   #           # #       #   #
# ### ### # # # ############# # # # ############# # ####### # #
#   # # # # # #         #   # #   #           #   #     #   # #
# # # # # # # # ####### # # # ##### ######### ### ### ### #####
# #   # # #   #     # # # # #   #   #       #       # #   #   #
# ##### # # ####### # # ### ### # ### ##### ######### # # # # #
#       # #     #   # #   #       #   #   #       #   # # # # #
# ####### ##### # ### ### ####### # ### # ####### # ### ### # #
# #       #     #   #   #       # # #   #     #   #   #     # #
# # ####### ####### # # ####### ### # ### ##### ##### ####### #
# # #     # #     #   # #     #   #   #   #     #     #     # #
# # # ### # ### # ##### # ### ### ##### ### ##### ##### ##### #
# # # # #       #   #   # # # # #     #   #   #   #   # #     #
### # # ########### # ### # # # # ### ### ### # ### # # # ### #
#   #   #     #     #     #     # # # # # # # #     #   # #   #
# ### ### ### # ########### ##### # # # # # # ####### ### # ###
# #   #   #   #       #     # #   # # # #   #       # #   #   #
# ##### ### ######### # ##### # ### # # ### ####### # # ##### #
#       #   #   #     #   #   # #   #     #     # # # #     # #
######### ### # # ####### # ### # ##### ####### # # # ##### # #
#     #   #   # # #     #   #   #       #     #   #   #     # #
# ### # ### ##### ##### ### # ### ####### ### ### ##### ##### #
#   # # #             #     # # # #         #   #   # # #   # #
### # # # ########### ####### # # # ######### ##### # # ### # #
#   #   # #     #   #   #   # #   #       #   #       # #   # #
# ####### ### # # # ### # # # # ######### # ### ####### # ### #
#     # # #   # # # #   # # # #     #   # # #   #     # #   # #
# ### # # # ##### # # ### # # ### ### # # # # ### ### # # # # #
#   # #     #     # #     #   # # #   #   # # #   #     # #   #
### # ####### ##### ########### # # ####### # # ######### #####
# # #         #   #       #     # #     # #   # #       # #   #
# # ############# ####### ##### # ##### # ##### # ##### ### # #
# # #           #       #     # #   # #     # #       #     # #
# # # # ####### ### ######### # ### # ##### # ############### #
#   # #   #   # #   #       # #           #     #           # #
# ### ### ### # # ### # ##### # ############### # ### ##### # #
#   #   # #   # #     # #     # #       #     # #   # #   # # #
### ### # # # # ##### # # ####### ##### # # ### ### # # ### # #
# #   # # # # #     # # #       #     #   #     # # # #   #   #
# ### ### # ####### ### ####### ##### ########### # ##### ### #
#         #                   #                   #       #   #
####################### #######################################
