63 63
  ####################################################### #####
#   #   #   #                       #     #         #     #   #
# # # ### # # ### ######### ######### ##### # ##### ##### ### #
# # # #   # #   # #       #         #       # #     #   # #   #
# # # # ### ### # # ##### ####### # ######### ##### # # # # ###
# # # #   # #   #   #   # #   #   #   #     #     #   #   #   #
# # # ### # ### # ### ### ### # ##### # ### ##### ######### # #
# #       #   # #   #     #   # #       # #     #     #     # #
# ########### ##### # ### # ##### ####### ### # ##### # ##### #
# #         #       # #   #       #   #       # #     #   #   #
# # ####### ########### ##### ##### ### ####### # ####### # ###
#   #   # # #           #     #   #   # #     # # #     # # # #
####### # # # ######### ##### # ##### # # ### # # # ### # # # #
#     # #   #   #     # #   # #       # # # # # # # #   # #   #
# # # # # ####### ### ### # # ####### # # # # # # # # ### # # #
# # # # # #       #     # # #   #     # #   #   # # #   # # # #
# # # # # # ### ####### # # ### # ##### ### ##### # ### ### # #
# # #   # # # # #     #   # #   #       #   #   # #   #     # #
# ####### # # # # # # ##### # ########### ### # # ### ####### #
# #     #   # #   # #     # #   #     #   #   # #   # #   #   #
# # # ####### # ######### # ### ##### # ### ### ### # # ### ###
# # #       #   #         # #         # #   # #     #   #     #
# # ####### ##### ### ##### ########### # ### ######### # #####
# #       #       #   # #     #   # #   #       #       # #   #
# ##### ############### # ### # # # # ######### # ######### # #
# #     #   #   #       #   #   #   # #       # #           # #
# # ##### # # ### # ### ##### ### ### ### ### # ############# #
# # #   # # # #   #   #   #   #     #   #   # #     #     #   #
# # # # # # # # ### ##### # ####### ### ### # ##### # # # # ###
#     # # # #   #   #   # # #     #   #     # #   #   # #     #
######### # # ### ### # # # # ### ##### ##### # ##### ####### #
#   #     # # #   #   #   #   # #     #   #   #       #     # #
### # ##### ### ### ########### ##### ### ##### ####### ##### #
#   #   #   #   #   #   #         #   #   #     #       #     #
# ##### # ### ### ### # # ##### ### ### # # # ### ##### # #####
#     # #     #   #   # #     #     #   # # # #   # #   #     #
##### # ####### ####### ######### ### ### # # ##### # # ##### #
#   #         # #     #   #     # # #   # # #       # # #     #
# # ######### # # # # ### ### # # # ### # # ##### ### # #######
# #   #       # # # #   #   # #   #   # # #     #     #       #
# ### # ####### # # ### ### # ##### # # # ######### ######### #
#   # # #       # #   #   # #   #   #   # #         #       # #
### # # ##### ##### # # # # ### ########### ############# ### #
#   # # #   #     # # # # #     #   #     #   #         # #   #
# ### # # # ##### # # # # ### ### # # ### ### # ####### # # ###
#   # #   # #   #   # # # # #     # # # #     #       #   #   #
### ##### ### # ##### # # # ####### # # # ####### ####### ### #
#     #   #   # #   # # #   # #   #   # #   #   #       #     #
# ### # ### ### # ### ####### # # ##### ### # # ##### #########
# #   #     # # #           #   # #     #   # #     #       # #
# # # ####### # ##### # ##### ### # ##### ### ##### ####### # #
# # # #       # #   # #     # # #   #   # # # #           # # #
# # ### ##### # # # ####### # # # ### # # # # # ######### # # #
# # #   #     #   # #     #   # #     #   #   #   #     # #   #
# # # ### ########### ### ##### # ############### ### # # # ###
# #   # # #   #       #   #       #             #   # # # #   #
# ##### # # # ##### ####### ####### ########### ### ### # ### #
#     # #   # #           #     #   #     #     # #   # #   # #
##### # ### # # ####### ### ##### ### # ### ##### ### # ### # #
#     #     #   #         #       #   # #   #   # #   #     # #
# # ##################### ######### # ### ### # # # ### ##### #
# #                     #           #         #   #   #       #
########################################################### ###